111111111111111111111
100000000000000000001
110000000000011100001
100000000000000000001
100000011100000100001
100000000000000100001
111111000000000100001
100000000000000100001
100000000000000000001
100000000011110000001
100100000000000000001
110000000000000000001
100000000000000000001
100000000000001110001
100010000000010000001
100010000000100000001
111111111111111111111
